50
.
44555556666666666666666555544443333322222222222111
44555566666666666666666555554444333332222222222221
44555566666666666666666555554444333333222222222222
45555566666666666666666655554444433333322222222222
45555666666667776666666655555444433333333222222222
45555666666677777666666655555444443333333322222222
55555666666777777666666665555544444433333333322222
55556666666777777766666665555554444443333333333222
55556666666777777766666666555555444444433333333333
55566666667777777766666666555555544444444333333333
55566666667777777766666666655555554444444444333333
55566666667777777766666666665555555554444444443333
55666666667777777766666666666555555555544444444443
55666666667777777666666666666655555555555544444444
55666666666777776666666666666666555555555555444444
56666666666676666666666666666666665555555555554444
56666666666666666666666666666666666666555555555544
56666666666666666666666666666666666666666555555554
56666666666666666666666666666666666666666665555555
66666666666666666666666666666666666666666666665555
66666666666666666666666666666666666666666666666555
66666666666666666666666666666666666666666666666665
66666666666666666666555566666666666666666666666666
66666666666666665555555555566666666666777776666666
66666666666666555555555555556666666667777777776666
66666666666665555555555555555666666667777777777666
66666666666655555555555555555566666667777777777766
66666666666555555555555555555556666667777777777777
66666666665555555544444445555555666667777777777777
66666666665555554444444444455555666667777777777777
66666666655555544444444444445555566666777777777777
66666666655555444444444444444555566666777777777777
66666666555555444444444444444455556666777777777777
66666666555554444443333334444455556666677777777777
66666666555544444433333333444445555666677777777777
66666665555544444333333333344444555666677777777777
66666665555444443333333333334444555566667777777777
66666665555444433333333333333444455566667777777777
66666655555444433333333333333344455556666777777777
66666655554444333333222223333344445556666677777777
66666555554444333332222222333334445555666677777777
66666555544443333322222222233334444555666666777777
66665555544443333322222222233333444555566666667766
66655555544443333222222222223333444555566666666666
66555555444433333222222222223333444455556666666666
55555555444433332222222222223333444455555666666666
55555554444433332222222222223333344455555566666666
55555554444333332222222222223333344445555556666665
55555544444333332222222222223333344445555555555555
55555444443333332222222222223333344444555555555555